################
#\.****####\#*##
#\.\\\\.***...##
##*####.#*###..#
#\.R....#...##\#
#\ ####...#.#*.#
#\ **######.#..#
##...\\\\\\...##
#L.##########.##
################