###########################
#\\\\\\\\\\\\#\\\\\\\\\\\\#
#\####\#####\#\#####\####\#
#.#  #\#   #\#\#   #\#  #.#
#\####\#####\#\#####\####\#
#\\\\\\\\\\\\\\\\\\\\\\\\\#
#\####\#\#########\#\####\#
#\\\\\\#\\\\\#\\\\\#\\\\\\#
######\#####\#\#####\######
     #\#           #\#
######\# #### #### #\######
L     \  #       #  \    **
######\# ######### #\######
     #\#           #\#
######\# ######### #\######
#\\\\\\\\\\\\#\\\\\\\\\\\\#
#\####\#####\#\#####\####\#
#.\\\#\      R      \#\\\.#
####\#\#\#########\#\#\####
#\\\\\\#\\\\\#\\\\\#\\\\\\#
#\##########\#\##########\#
#\\\\\\\\\\\\\\\\\\\\\\\\\#
###########################